{
	"levels":[
		[
			["c","c","c","c","c","c","c","c","c","c","c","c","c","c","c","c","c","c","c","c","c","c","c","c","c","c","c","c","c","c","c","c","c","c","c","c","c","c","c","c"],
			["c","w","c","c","c","w","w","w","c","w","c","w","c","w","w","w","c","w","c","c","c","c","c","c","c","c","c","c","c","c","c","c","c","c","c","c","c","c","c","c"],
			["c","w","c","c","c","w","c","c","c","w","c","w","c","w","c","c","c","w","c","c","c","c","c","c","c","c","c","c","c","c","c","c","c","c","c","c","c","c","c","c"],
			["c","w","c","c","c","w","w","w","c","w","c","w","c","w","w","w","c","w","c","c","c","c","c","c","c","c","c","c","c","c","c","c","c","c","c","c","c","c","c","c"],
			["c","w","c","c","c","w","c","c","c","w","c","w","c","w","c","c","c","w","c","c","c","c","c","c","c","c","c","c","c","c","c","c","c","c","c","c","c","c","c","c"],
			["c","w","w","w","c","w","w","w","c","c","w","c","c","w","w","w","c","w","w","w","c","c","c","c","c","c","c","c","c","c","c","c","c","c","c","c","c","c","c","c"],
			["c","c","c","c","c","c","c","c","c","c","c","c","c","c","c","c","c","c","c","c","c","c","c","c","c","c","c","c","c","c","c","c","c","c","c","c","c","c","c","c"],
			["c","c","c","c","c","c","c","c","w","c","c","c","w","c","c","w","w","c","c","w","w","w","w","w","c","c","c","c","c","c","c","c","c","c","c","c","c","c","c","c"],
			["c","c","c","c","c","c","c","c","w","w","c","c","w","c","w","c","c","w","c","c","c","w","c","c","c","c","c","c","c","c","c","c","c","c","c","c","c","c","c","c"],
			["c","c","c","c","c","c","c","c","w","c","w","c","w","c","w","c","c","w","c","c","c","w","c","c","c","c","c","c","c","c","c","c","c","c","c","c","c","c","c","c"],
			["c","c","c","c","c","c","c","c","w","c","c","w","w","c","w","c","c","w","c","c","c","w","c","c","c","c","c","c","c","c","c","c","c","c","c","c","c","c","c","c"],
			["c","c","c","c","c","c","c","c","w","c","c","c","w","c","c","w","w","c","c","c","c","w","c","c","c","c","c","c","c","c","c","c","c","c","c","c","c","c","c","c"],
			["c","c","c","c","c","c","c","c","c","c","c","c","c","c","c","c","c","c","c","c","c","c","c","c","c","c","c","c","c","c","c","c","c","c","c","c","c","c","c","c"],
			["c","c","c","c","c","c","c","c","c","c","c","c","c","c","c","c","c","c","c","c","c","c","c","c","c","c","c","c","c","c","c","c","c","c","c","c","c","c","c","c"],
			["c","w","w","c","c","w","c","w","c","w","c","w","c","c","c","w","w","w","c","c","c","c","c","c","c","c","c","c","c","c","c","c","c","c","c","c","c","c","c","c"],
			["c","w","c","w","c","w","c","w","c","w","c","w","c","c","c","c","w","c","c","c","c","c","c","c","c","c","c","c","c","c","c","c","c","c","c","c","c","c","c","c"],
			["c","w","w","c","c","w","c","w","c","w","c","w","c","c","c","c","w","c","c","c","c","c","c","c","c","c","c","c","c","c","c","c","c","c","c","c","c","c","c","c"],
			["c","w","c","w","c","w","c","w","c","w","c","w","c","c","c","c","w","c","c","c","c","c","c","c","c","c","c","c","c","c","c","c","c","c","c","c","c","c","c","c"],
			["c","w","w","c","c","w","w","w","c","w","c","w","w","w","c","c","w","c","c","c","c","c","c","c","c","c","c","c","c","c","c","c","c","c","c","c","c","c","c","c"],
			["c","c","c","c","c","c","c","c","c","c","c","c","c","c","c","c","c","c","c","c","c","c","c","c","c","c","c","c","c","c","c","c","c","c","c","c","c","c","c","p"]
		],
		[
			["x","o","o","o","o","w","o","o","w","w","w","o","o","o","o","w","o","o","o","o","w","w","w","o","o","o","w","o","c","o","o","o","o","c","o","o","o","o","o","o"],
			["c","w","w","w","o","o","w","o","o","o","o","w","w","o","w","w","o","w","o","w","o","o","o","o","w","o","o","o","w","w","w","w","w","w","w","o","w","c","w","w"],
			["c","c","c","o","w","o","o","w","w","w","o","c","w","o","w","o","w","w","o","w","o","w","w","w","w","w","w","c","w","o","o","o","w","w","w","o","w","c","o","o"],
			["o","w","w","o","o","w","o","c","o","o","w","o","o","o","o","w","c","o","o","w","o","w","o","o","o","c","o","o","w","o","w","o","w","w","w","o","w","w","w","o"],
			["c","o","o","w","o","w","w","w","w","o","o","w","w","w","w","o","c","w","w","w","o","w","o","w","w","w","w","o","w","o","w","o","w","w","w","o","c","w","o","o"],
			["o","w","o","w","c","w","c","c","o","w","o","o","w","w","w","o","w","o","o","c","o","w","o","w","o","o","o","o","w","c","w","o","w","w","w","w","o","w","o","w"],
			["o","w","o","w","o","c","o","w","o","w","w","o","o","o","o","c","w","o","w","o","w","w","o","w","o","w","w","w","w","o","w","o","c","o","o","o","w","w","o","o"],
			["o","w","w","w","w","w","w","w","c","o","o","w","w","w","w","w","w","o","w","o","w","w","o","w","o","w","w","w","w","c","o","w","w","w","w","o","w","w","w","o"],
			["o","o","c","o","o","o","o","o","w","w","o","o","o","c","o","o","w","o","w","c","w","o","o","w","o","o","o","c","o","o","w","o","o","o","w","o","w","w","c","o"],
			["w","w","w","w","w","w","w","o","w","w","w","w","w","w","w","o","w","o","w","o","w","w","w","w","w","w","w","w","w","w","w","o","w","c","o","o","o","w","o","w"],
			["o","w","w","o","c","o","w","o","w","o","w","o","o","o","w","c","w","o","w","o","o","o","o","o","c","o","o","o","o","o","w","o","w","c","w","w","w","w","o","w"],
			["o","w","o","o","w","o","w","o","w","c","w","o","w","o","w","o","w","o","w","w","w","w","w","w","w","w","w","w","w","o","w","o","w","c","w","o","o","o","o","w"],
			["o","o","c","w","w","o","w","o","w","o","w","o","w","o","w","o","w","w","w","w","w","w","c","o","o","w","w","w","w","o","w","o","w","o","w","o","w","w","w","w"],
			["c","w","w","w","w","o","w","o","w","o","w","o","w","o","w","o","w","c","c","c","o","w","o","w","o","o","o","o","c","o","w","o","w","o","w","o","o","o","c","w"],
			["o","w","w","w","w","o","w","o","w","o","w","o","w","o","w","c","w","o","w","w","w","w","o","w","w","w","w","w","w","w","w","o","w","w","w","w","w","w","o","w"],
			["c","w","w","w","w","o","o","o","w","o","w","o","w","o","c","o","w","o","o","o","o","w","o","w","w","w","w","w","w","w","w","c","o","o","o","o","o","w","o","w"],
			["c","w","o","o","o","w","w","w","w","o","w","o","w","w","w","w","w","w","w","w","o","w","c","c","o","o","w","w","w","w","w","o","w","o","w","w","w","w","o","w"],
			["o","w","o","w","c","o","o","o","o","o","w","o","w","w","c","o","o","w","w","o","o","o","w","w","w","o","w","w","w","w","c","o","w","o","w","o","o","o","o","w"],
			["c","w","o","w","w","w","w","w","w","w","w","o","w","w","o","w","o","w","w","o","w","o","w","c","o","o","w","w","w","w","o","w","w","o","w","o","w","o","w","w"],
			["c","o","o","w","o","o","o","o","c","o","o","o","o","o","o","w","c","o","o","o","w","o","o","o","w","c","o","o","o","o","o","o","w","c","o","o","w","o","o","p"]
		],
		[
			["x","w","w","w","w","o","w","w","o","o","o","w","w","w","w","o","w","w","w","w","o","o","o","w","w","w","o","w","c","w","w","w","w","c","w","w","w","w","w","w"],
			["c","o","o","o","w","w","o","w","w","w","w","o","o","w","o","o","w","o","w","o","w","w","w","w","o","w","w","w","o","o","o","o","o","o","o","w","o","c","o","o"],
			["c","c","c","w","o","w","w","o","o","o","w","c","o","w","o","w","o","o","w","o","w","o","o","o","o","o","o","c","o","w","w","w","o","o","o","w","o","c","w","w"],
			["w","o","o","w","w","o","w","c","w","w","o","w","w","w","w","o","c","w","w","o","w","o","w","w","w","c","w","w","o","w","o","w","o","o","o","w","o","o","o","w"],
			["c","w","c","o","w","o","o","o","o","w","w","o","o","o","o","w","c","o","o","o","w","o","w","o","o","o","o","w","o","w","o","w","o","o","o","w","c","o","w","w"],
			["w","o","w","o","c","o","c","c","w","o","w","w","o","o","o","w","o","w","w","c","w","o","w","o","w","w","w","w","o","c","o","w","o","o","o","o","w","o","w","o"],
			["w","o","w","o","w","c","w","o","w","o","o","w","w","w","w","c","o","w","o","w","o","o","w","o","w","o","o","o","o","w","o","w","c","w","w","w","o","o","w","w"],
			["w","o","o","o","o","o","o","o","c","w","w","o","o","o","o","o","o","w","o","w","o","o","w","o","w","o","o","o","o","c","w","o","o","o","o","w","o","o","o","w"],
			["w","w","c","w","w","w","w","w","o","o","w","w","w","c","w","w","o","w","o","c","o","w","w","o","w","w","w","c","w","w","o","w","w","c","o","w","o","o","c","w"],
			["o","o","o","o","o","o","o","w","o","o","o","o","o","o","o","w","o","w","o","w","o","o","o","o","o","o","o","o","o","o","o","w","o","c","w","w","w","o","c","o"],
			["w","o","o","w","c","w","o","w","o","w","o","w","w","w","o","c","o","w","o","w","w","w","w","w","c","w","w","w","w","w","o","w","o","c","o","o","o","o","w","o"],
			["w","o","w","w","o","w","o","w","o","c","o","w","o","w","o","w","o","w","o","o","o","o","o","o","o","o","o","o","o","w","o","w","o","c","o","w","w","w","w","o"],
			["w","w","c","o","o","w","o","w","o","w","o","w","o","w","o","w","o","o","o","o","o","o","c","w","w","o","o","o","o","w","o","w","o","w","o","w","o","o","o","o"],
			["c","o","o","o","o","w","o","w","o","w","o","w","o","w","o","w","o","c","c","c","w","o","w","o","w","w","w","w","c","w","o","w","o","w","o","w","w","w","c","o"],
			["w","o","o","o","o","w","o","w","o","w","o","w","o","w","o","c","o","w","o","o","o","o","w","o","o","o","o","o","o","o","o","w","o","o","o","o","o","o","w","o"],
			["c","o","o","o","o","w","w","w","o","w","o","w","o","w","c","w","o","w","w","w","w","o","w","o","o","o","o","o","o","o","o","c","w","w","w","w","w","o","w","o"],
			["c","o","w","w","w","o","o","o","o","w","o","w","o","o","o","o","o","o","o","o","w","o","c","c","w","w","o","o","o","o","o","w","o","w","o","o","o","o","w","o"],
			["w","o","w","o","c","w","w","w","w","w","o","w","o","o","c","w","w","o","o","w","w","w","o","o","o","w","o","o","o","o","c","w","o","w","o","w","w","w","w","o"],
			["c","o","w","o","o","o","o","o","o","o","o","w","o","o","w","o","w","o","o","w","o","w","o","c","w","w","o","o","o","o","w","o","o","w","o","w","o","w","o","o"],
			["c","w","w","o","w","w","w","w","c","w","w","w","w","w","w","o","c","w","w","w","o","w","w","w","o","c","w","w","w","w","w","w","o","c","w","w","o","w","w","p"]
		]
	]
}